R 1920 1080
NO ./textures/colorstone.xpm
SO ./textures/bluestone.xpm
WE ./textures/greystone.xpm
EA ./textures/wood.xpm

S ./textures/barrel.xpm
F 255,248,220
C 135,206,250

 1111111111111111111111111
1000000000110000010000001
1011000001110000101010001
10010000000000000101 1001
1111111110110000011110001
1000000000110000011101111
1111011111111101110000001
1111011111111100000101001
110000001101N101110000001
1000000000000000110000001
10000000000000001101010001
1100000111010101111101101
1111011111110101 100011101
1111111111111111 1111111